0000000000000000000000000000
0000000000000000000000000000
0000000000000000000000000000
6111111111111561111111111115
2777777777777227777877777772
2761157611157227611157611572
2720027200027227200027200272
2741137411137437411137411372
2777777777778777777777777772
2761157657611111157657611572
2741137227411561137227411372
27777s722777722777722777s772
2761157241157227611327611572
2720027261137437411527200272
2720027227777777777227200272
2720027227611111157227200272
2741137437200000027437411372
27787777772000000277777s7772
4111157657200000027657611113
0000027227411111137227200000
0000027227777p77777227200000
0000027227611111157227200000
6111137437411561137437411115
27777s7777777227777777777772
2761157611157227611157611572
2741527411137437411137261372
2777227777777787777777227772
4157227657611111157657227613
6137437227411561137227437415
2777777227777227777227777772
2761111341157227611341111572
2741111111137437411111111372
2777777777777777777777777772
4111111111111111111111111113
0000000000000000000000000000
0000000000000000000000000000